000 000 000 000 000 100 100 100 100 100 100 000 000 100 020 000 100 100 100 100
000 000 000 000 000 100 100 100 100 100 100 000 000 100 000 000 100 100 100 100
000 000 000 000 000 100 000 020 100 100 100 000 000 100 000 000 100 000 020 100
000 000 020 000 000 100 000 000 000 100 100 000 000 100 000 000 000 000 000 100
000 000 000 000 000 100 100 100 030 100 100 100 100 100 000 000 100 000 000 100
000 000 000 000 000 100 000 016 000 000 000 000 030 000 000 030 100 000 100 000
020 000 000 020 000 100 000 000 000 000 000 000 000 000 000 000 100 100 100 100
000 000 000 000 000 100 100 100 100 100 000 000 000 100 000 000 000 000 000 000
000 000 000 000 000 100 100 100 100 100 000 000 000 100 000 000 000 000 000 020
000 000 000 000 000 100 000 030 000 100 000 100 000 000 000 100 000 000 000 000
100 100 000 100 100 100 100 000 100 100 000 100 000 000 000 100 000 000 000 000
000 100 000 000 000 000 000 000 000 000 000 000 000 100 000 030 000 000 000 000
020 000 000 000 000 000 000 015 000 000 000 000 000 100 000 000 000 000 000 020
000 000 000 000 000 000 000 000 000 000 000 000 000 000 000 011 000 000 000 000
000 000 000 000 000 000 000 000 000 000 000 000 000 012 000 000 000 000 000 020
000 000 000 000 000 000 000 000 000 000 000 000 000 000 000 000 000 000 000 000
000 000 000 000 000 000 000 000 000 000 000 000 000 000 000 000 000 000 000 000
000 000 000 000 000 000 000 000 000 000 000 010 000 000 017 000 000 000 000 000
000 000 000 000 000 000 000 000 000 000 000 000 000 000 000 000 000 000 000 000
000 000 020 000 000 000 000 000 200 000 000 000 000 000 000 000 000 000 000 000