100 100 100 100 100 100 100 100 100 000 100 100 100 100 100 100 100 100 100 100
100 100 100 100 100 100 100 100 100 000 100 100 100 100 100 100 100 100 100 100
100 000 000 020 000 000 000 000 000 000 000 000 000 000 000 000 000 000 020 100
100 000 000 000 000 000 100 100 100 000 100 100 100 100 100 000 100 100 100 100
100 020 000 000 100 100 100 100 100 000 100 100 100 100 100 000 100 100 100 100
100 000 000 000 100 100 100 000 000 000 100 000 000 000 000 000 000 000 000 100
100 000 020 020 100 000 000 000 100 000 100 000 000 020 000 000 000 000 020 100
100 000 000 000 100 000 000 000 100 000 100 000 100 100 100 100 100 100 100 100
100 100 100 100 100 100 100 100 100 000 100 100 100 100 100 100 100 100 100 100
100 100 100 100 100 100 100 100 100 000 100 100 100 000 000 000 000 000 000 100
100 000 000 000 000 000 000 000 000 030 000 030 030 000 100 100 100 100 000 100
100 000 000 100 100 100 100 100 100 100 100 100 100 100 100 100 100 100 000 100
100 000 000 100 100 100 100 100 100 100 100 100 100 100 100 100 100 100 000 100
100 100 100 100 000 000 000 030 000 000 000 000 000 000 100 100 100 100 000 100
100 100 100 100 000 100 100 100 000 000 100 100 100 000 020 000 000 000 000 100
100 020 000 000 000 100 100 100 000 000 100 100 100 020 000 000 000 000 000 100
100 020 020 020 000 100 000 012 000 000 000 013 100 100 100 100 100 100 100 100
100 100 100 100 100 100 100 100 000 100 100 100 100 100 100 100 100 100 100 100
100 100 100 100 100 100 011 000 000 000 000 000 100 100 100 100 100 100 100 100
100 100 100 100 100 100 100 100 210 100 100 100 100 100 100 100 100 100 100 100