100 100 100 000 000 000 000 000 000 000 100 000 000 000 000 000
100 100 100 000 030 000 011 000 000 000 100 000 000 000 000 000
100 100 100 100 100 100 100 100 100 100 100 000 000 000 020 000
000 000 000 000 000 000 000 000 100 000 000 000 000 000 000 000
000 000 000 000 000 000 000 000 100 000 000 000 000 000 000 000
000 000 000 000 000 000 000 000 100 000 000 000 000 000 020 000
200 000 000 000 000 000 000 000 100 000 000 000 000 000 000 000
000 000 000 000 000 000 000 000 100 000 000 010 000 000 000 000
000 000 000 000 000 000 000 000 000 000 000 000 000 000 000 000